111111111111111111
1CG100110C100010C1
100000E10110001001
1O0100110000101001
100100000011100001
100001011000001001
1011010C1011111011
1C00011010G01C0001
1001010000100001O1
110101111011011101
1C0100C00000C00P01
111111111111111111
